EA     ./textures/wall2.xpm

R         100 100

F 255,255,255

NO ./textures/wood.xpm             

SO ./textures/wall4.xpm

WE ./textures/././wall3.xpm

S ./textures/barrel.xpm
C 179,250,248

1111111111111111
100000000000000011111111111111111111111111
100000002000000100000002200000002222222221
100000000000000012000000000202222222222221
11111111111111111111111111111111111111111
111111111111111111111111111111111111111111
1000200020002000101 1000000000000000000001
100000000000000000010200000000000000000001
102020200020202010000200000000000000000001
1011111111111111111120111111111111111110001      1111111111111
101111111111111110000000000002000000000001       10000000000001
1000000000000000000000N000001000000000111       10000000000001
100020002002000012222202222002222222222221       1111111111111
100000000000000012222222200000022222222221
102000002000020011111111111011111111111111
10000000000000001          1
11111111111111111
1111111
10000001
100020001
1000000001             111
1111111111             101
                       111
                       
                       1111111
                       1200001
                       1000001
                       1000001
                       1111111